XXXXXXXXXXXXXXXXXXXXX
X   X X     X       X
XXX X X XXXXX XXX XXX
X X           X X   X
X XXX XXXXXXXXX XXX X
  X             X    
X X X XXX X X XXXXXXX
X   X   X X X       X
X X XXX XXXXX XXXXXXX
X X   X     X       X
X XXX XXXXX XXXXXXXXX
X X       X         X
X XXX XXX XXXXX XXX X
X   X   X     X   X X
X XXX X X X XXXXX XXX
X X   X X X     X X X
X X XXXXX X XXXXX X X
X X   X   X X       X
XXX XXXXX X XXXXX X X
X     X   X X     X X
XXXXXXXXXXXXXXXXXXXXX
